এই পাতাটি বিশ্বের বিভিন্ন জাতির রাষ্ট্রীয় ও জাতীয় নীতিবাক্যসমূহের একটি তালিকা। এই তালিকায় এমন কিছু দেশ যুক্ত করা হয়েছে, যেগুলোর আন্তর্জাতিক স্বীকৃতি নেই, সাবেক রাষ্ট্র বা প্রদেশ তবে তাদের নাম মোটা অক্ষরে লেখা হয় নি।
নীতিবাক্যে সাধারনত এক বাক্যের প্রেরণামূলক কোন বাগধারা লেখা থাকে। উদাহরণস্বরুপ, এটি রাষ্ট্রের পতাকা, বিভিন্ন সামরিক সরঞ্জামে বা মুদ্রায় লেখা থাকতে পারে।




নির্দেশিকা: অ আ ই ঈ উ ঊ ঋ এ ঐ ও ঔ ক খ গ ঘ ঙ চ ছ জ ঝ ঞ ট ঠ ড ঢ ণ ত থ দ ধ ন প ফ ব ভ ম য র ল শ ষ স হ ড় ঢ় য় ৎ



অ

 অস্ট্রেলিয়া: অগ্রগামী অস্ট্রেলীয়া
 অস্ট্রিয়া: অস্ট্রীয়াই এস্ট ইমপেরারি অরবি ইউনিভার্সো (লাতিন, অস্ট্রিয়ার লক্ষ্যই হল বিশ্ব শাসন করা)[তথ্যসূত্র প্রয়োজন]
 অস্ট্রিয়া-হাঙ্গেরি: ইনভিজিবিলিটার এসি ইনসেপারাবিলিটার (লাতিন, অভিবক্তভাবে ও অঙ্গাঙ্গিভাবে)
 অটোম্যান সাম্রাজ্য: دولت ابد مدت (অটোম্যান তুর্কী, শাশ্বত রাজ্য)[তথ্যসূত্র প্রয়োজন]

আ

 আফগানিস্তান: সরকারি কোন নীতিবাক্য নেই।
 আলবেনিয়া: টি শকিপেরি মি জেপ এনদের, মি জেপ এমরিন শকিপেতার (আলবেনিয়ান, তুমি, আলবেনিয়া, আমাকে সম্মান দাও, আমাকে আলবেনিয়ান নাম দাও)[তথ্যসূত্র প্রয়োজন]
 আলজেরিয়া: بالشعب و للشعب (বিল-সাআ‘ব ওয়া লিল-সাআ‘ব) (আরবি, জনগণ ও জনগণের জন্য)
 আমেরিকান সামোয়া: সামুয়া মুয়ামুয়া লে আতুয়া (সামুয়ান, সামুয়া, প্রথমে ঈশ্বরের নামে শুরু করা যাক)
 অ্যান্ডোরা: ভিরতাস ইউনিতা ফোর্টিয়র (লাতিন, শক্তি, ঐক্যই শক্তি)
 অ্যাঙ্গোলা: রিপাবলিকা দে অ্যাঙ্গোলা (পর্তুগীজ, গণপ্রজাতন্ত্রী অ্যাঙ্গোলা)[তথ্যসূত্র প্রয়োজন]
টেমপ্লেট:দেশের উপাত্ত আংগুলা: শক্তি ও সহিষ্ণুতা[তথ্যসূত্র প্রয়োজন]
 অ্যান্টিগুয়া ও বার্বুডা: প্রতিটি ক্ষেত্রে তৎপর হও, সবকিছু অর্জন করতে পারবে
 আর্জেন্টিনা: এন ইউনিয়ন ইয়ে লিবার্টেড (স্প্যানীয়, ঐক্য ও মুক্তি)
 আর্মেনিয়া: Մեկ Ազգ, Մեկ Մշակույթ (ম্যাক এজ্‌, ম্যাক মাসাক্যুয়েত) (আর্মেনিয়া, "এক জাতি, এক সংস্কৃতি")
 আরুবা: সেমপের প্রু গ্রেডিয়েন্স (লাতিন, সর্বদা উন্নয়নশীল)
 আজারবাইজান: সরকারি কোন নীতিবাক্য নেই
 আজোরেস: এন্তেস মোরার লিবরেস ক্যুই এম পাজ সুজিতুস (পর্তুগীজ, দাস হিসেবে শান্তিতে থাকার চেয়ে, মুক্ত হিসেবে মৃত্যুবরণ ভাল)[তথ্যসূত্র প্রয়োজন]

টেমপ্লেট:দেশের উপাত্ত আপার ভোল্টা প্রজাতন্ত্র: ইউনাইট, ট্রাভেইল, জাস্টিস (ফরাসি, ঐক্য, কাজ, বিচার)[তথ্যসূত্র প্রয়োজন]


 আইসল্যান্ড: সরকারি কোন নীতিবাক্য নেই।
 আয়ারল্যান্ড: কোন সরকারি নীতিবাক্য নেই।
 আইল অফ ম্যান: কুকানকু ইসেরিস স্টাবিট (লাতিন ভাষা আপনি যেখানেই নিক্ষেপ করুন না কেন, এটা থাকবেই)[তথ্যসূত্র প্রয়োজন]

ই


 ইকুয়েডর: দিওস, পাত্রিয়া ই লিবার্টেড (স্প্যানিশ, ঈশ্বর, মাতৃভূমির, স্বাধীনতা)[তথ্যসূত্র প্রয়োজন]
 ইংল্যান্ড: দাইও এট মুন ড্রাইট (ফরাসি, ঈশ্বর আমার সাথে) (রাজকীয় নীতিবাক্য)[তথ্যসূত্র প্রয়োজন], "এই সবুজ এবং আনন্দদায়ক ভূমি" (আনঅফিসিয়াল)[তথ্যসূত্র প্রয়োজন]
 ইরিত্রিয়া: دولة إرترݐا (দৌলট ইরিত্রিয়া), "হাজেরে ইরত্রা" (আরবি, টিগরিনা, ইরিত্রিয়া রাষ্ট্র)
 ইস্তোনিয়া: রাষ্ট্রীয় পর্যায়ে কোন নীতিবাক্য নেই কিন্তু বিশ্বের সামনে তুলে ধরতে, ইস্তোনিয়ায় স্বাগতম এবং হেডে উল্লাতুসতে মা (ইস্তোনিয়া, চমকের দেশ) ব্যবহার হয়ে থাকে।
 ইথিওপিয়া: সাবেক "ইথিওপিয়া তাবেতসি ইদিওইয়া হাবে ইগজিয়াবিহের" (আমহারিক, ইথিওপিয়া ঈশ্বরের প্রতি তার মাথা নত করে) বর্তমানে কোন নীতিবাক্য নেই।[তথ্যসূত্র প্রয়োজন]

১৯৩০ থেকে ১৯৭৫ সালের মধ্যে ইমপেরিয়াল নীতিবাক্য ছিল, "মুয়া আমবাসা জি ইমনেজিদি ইয়েহুদা" (আমহারিক, জুধা উপজাতির আক্রমনকারী সিংহ)[তথ্যসূত্র প্রয়োজন]


 ইউরোপীয় ইউনিয়ন: ইউনিটা নেল্লা ডাইভারসিটা, ঐক্যেই বৈচিত্রতা
 ইন্দোনেশিয়া: বিন্নিকা টাংগাল ইকা (পুরাতন জাবানীজ, বৈচিত্র্য মধ্যে একতা)
 ইরান:

দে ফ্যাক্টো: استقلال، آزادى، جمهورى اسلامى (এস্তেকাল, আজাদি, জুমহুরি-ইয়ে ইসলামি) (ফার্সি, স্বাধীনতা, মুক্তি, ইসলামী প্রজাতন্ত্র)
দে জুরি: الله اکبر (আল্লাহু আকবার) (আরবি, আল্লাহ্‌ মহান)
The imperial motto, before the Islamic revolution, was مرا داد فرمود و خود داور است (Marā dād farmūd-o khod dāvar ast) (Persian, Justice He bids me do, as He will judge me).


 ইরাক: الله أكبر (আল্লাহু আকবার) (আরবি, আল্লাহ্‌ মহান)
 ইসরায়েল: সরকারি কোন নীতিবাক্য নেই।
 ইতালি: সরকারি কোন নীতিবাক্য নেই।

 Kingdom of Italy (1861-1946): Foedere et Religione Tenemur (FERT) (Latin, We are held together by pact and by religion)[তথ্যসূত্র প্রয়োজন]
 ইতালীয় সামাজিক প্রজাতন্ত্র:(puppet state of Nazi Germany during the later part of World War II) Per l'onore d'Italia(Italian, For honor of Italy)[তথ্যসূত্র প্রয়োজন]


 ইয়েমেন: الڷه، الوطن، الثورة، الوحدة (আল্লাহ্‌, আল-ওয়াতান, আত-তাওরাহ্‌, আল-ওয়াহ্‌দাহ্‌) (আরবি, আল্লাহ্‌, জাতি, বিপ্লব, একতা)[তথ্যসূত্র প্রয়োজন]

 দক্ষিণ ইয়েমেন: جمهرݐة الݐمن الدݐمقراطݐة الشعبݐة (জুমুরায়া আল-ইয়েমেন আদ-দিমুক্রেত্রিয়া আশ-শাবিয়াহ্‌) (আরবি, গণতান্ত্রিক গণপ্রজাতন্ত্রী ইয়েমেন)[তথ্যসূত্র প্রয়োজন]


 ইউক্রেন: Слава Україні! (স্লাভা ইউক্রেনি) (ইউক্রেনিয়ান, ইউক্রেনে পূণ্য হোক!) (বেসরকারী)[তথ্যসূত্র প্রয়োজন]

উ


 উদমার্টিয়া: Удмурт Республика; Удмуртская Республика (উদমার্ত, রাশিয়ান, উদমার্ত প্রজাতন্ত্র)[তথ্যসূত্র প্রয়োজন]
 উগান্ডা: ঈশ্বর এবং আমার দেশের জন্য
 উরুগুয়ে: লিবার্টেড ও মুয়ের্তে (স্প্যানীয়, "স্বাধীনতা অথবা মৃত্যু")
 উজবেকিস্তান: কুচ আদুলাতদাদির! (উজবেক বিচার খুব শক্তিশালী)[তথ্যসূত্র প্রয়োজন]
 উত্তর সাইপ্রাস: সরকারি কোন নীতিবাক্য নেই।

এ

 এল সালভাদোর: দিওস, ইউনিয়ন, লিবার্টেড (স্প্যানিশ, ঈশ্বর, ইউনিয়ন, লিবার্টি)

ও

 ওমান: সরকারি কোন নীতিবাক্য নেই।
টেমপ্লেট:দেশের উপাত্ত ওয়েল্‌স্‌: চেমরো অ্যাম বেথ (ওয়েল্‌স্‌, ওয়েল্‌স্‌ চীরজীবী)[তথ্যসূত্র প্রয়োজন]
 ওয়েস্ট ইন্ডিজ ফেডারেশন: ঐক্য, একসঙ্গে বাস[তথ্যসূত্র প্রয়োজন]

ক

 কম্বোডিয়া:  (চিট, সাসনা, প্রিয়াহমুহাকসাত) (খ্‌মের, জাতি, ধর্ম, রাজা)
 ক্যামেরুন: পাইক্স-ট্রাভেইল-পাত্রি (ফরাসি, শান্তি, কাজ, জন্মভূমি)
 কানাডা: অ্য মারি উসকু এড মারে (লাতিন, সমুদ্র থেকে সমুদ্রে)

See also List of Canadian provincial and territorial symbols


 কানারি দ্বীপপুঞ্জ: ওসিয়ানো (স্প্যানিশ, মহাসাগর)[তথ্যসূত্র প্রয়োজন]
 কেপ ভার্দ: রিপাবলিকা দে কাবু ভেদ্রে (পর্তুগীজ, কেপ ভার্দে প্রজাতন্ত্র)[তথ্যসূত্র প্রয়োজন]
 কেইম্যান দ্বীপপুঞ্জ: তিনি সমুদ্রপথে এটি প্রতিষ্ঠা করেছেন[তথ্যসূত্র প্রয়োজন]
 কলম্বিয়া: লিবার্টেড ইয়ে অর্দেন (স্প্যানিশ, স্বাধীনতা ও শৃঙ্খলা)[তথ্যসূত্র প্রয়োজন]
 কোমোরোস: ইউনাইট, জাস্টিস, প্রোগ্রেস (ফরাসি, ঐক্য, ন্যায়বিচার, অগ্রগতি)[তথ্যসূত্র প্রয়োজন]
 কনফেডারেট স্টেটস অফ আমেরিকা: দিও ভিন্দিস (লাতিন, ঈশ্বরের অধীনে, আমাদের সত্যতা প্রমানকারী)
 কঙ্গো প্রজাতন্ত্র: ইউনাইট, ট্রাভেইল, প্রোগ্রেস (ফরাসি, ঐক্য, কাজ, উন্নতি)
 কুক দ্বীপপুঞ্জ: সরকারি কোন নীতিবাক্য নেই।
 কোস্টা রিকা: ভিবান সিয়েমপের এল ট্রাবাজু ইয়ে লা পাজ (স্প্যানীয়, জিন্দাবাদ কাজ ও শান্তি)[তথ্যসূত্র প্রয়োজন]
 ক্রোয়েশিয়া: সরকারি কোন নীতিবাক্য নেই।
 কোত দিভোয়ার: ইউনিয়ন, ডিসিপ্লিন, ট্রাভেইল (ফরাসি, ঐক্য, শৃঙ্খলা, শ্রম)
 কিউবা: পাত্রিয়া ও মুয়েত্রি (স্প্যানিশ, স্বদেশ বা মৃত্যু)



 কাজাখস্তান: সরকারি কোন নীতিবাক্য নেই।
 কেনিয়া: হারাম্বি (সোহালি, "চল ঐক্যবদ্ধভাবে কাজ করি")[তথ্যসূত্র প্রয়োজন]
 কিরিবাস: তে মাউরি, তে রাউই ও তে তাবুমোয়া (কিরিবাস, "স্বাস্থ্য, শান্তি ও সমৃদ্ধি")[তথ্যসূত্র প্রয়োজন]
 কসোভো: সরকারি কোন নীতিবাক্য নেই।
 উত্তর কোরিয়া: 강성대국 (强盛大國, দাংসিওং দাগুক) (কোরীয়, সমৃদ্ধ ও মহান দেশ)[তথ্যসূত্র প্রয়োজন]
 দক্ষিণ কোরিয়া: 홍익인간 (弘益人間, হগিক ইনগান) (কোরীয়, বিস্তৃতভাবে মানব বিশ্বের উপকার)[তথ্যসূত্র প্রয়োজন]

 কোরিয়ান সাম্রাজ্য: 광명천지 (光明天地, ওয়াংমেওং চেওনজি) ভূমি জুড়ে আলো জ্বালোন[তথ্যসূত্র প্রয়োজন]


 কুয়েত: دولة الکوݐت (দৌলত আল-কুয়েতা) (আরবি, কুয়েত রাষ্ট্র)[তথ্যসূত্র প্রয়োজন]
 কিরগিজিস্তান: Кыргыз Республикасы (কিরগিজ, কিরগিজ প্রজাতন্ত্র)[তথ্যসূত্র প্রয়োজন]
 কাতার: دولة قطر (দৌলাত কাতার) (আরবি, কাতার রাষ্ট্র)[তথ্যসূত্র প্রয়োজন]

গ

টেমপ্লেট:দেশের উপাত্ত গাবন: ইউনিয়ন, ট্রাভেইল, জাস্টিস (ফরাসি, ঐক্য, কাজ, ন্যায়বিচার)
টেমপ্লেট:দেশের উপাত্ত দ্য গাম্বিয়া: অগ্রগতি, শান্তি, সমৃদ্ধি
 ঘানা: স্বাধীনতা ও ন্যায়বিচার
 গ্রিস: Ελευθερία ή θάνατος (এলেফথেরিয়া আই থানাতুস) (গ্রিক: স্বাধীনতা বা মৃত্যু)[তথ্যসূত্র প্রয়োজন]

গ্রিস রাজ্য (১৮৩১-১৯২৪ এবং ১৯৩৫-৬৭): Ίσχύς μου ή άγάπη του λαού (গ্রিক: ইসকিস মিউ আই আয়াপাই আই তু লাউ, মানুষের ভালবাসাই আমাদের শক্তি)[তথ্যসূত্র প্রয়োজন]


 গ্রিনল্যান্ড: সরকারি কোন নীতিবাক্য নেই।
 গ্রানাডা: কখনও আমরা ঈশ্বর সচেতন উচ্চাভিলাষী, এবং অগ্রিম এক মানুষ
 গুয়াম: সরকারি কোন নীতিবাক্য নেই।
 গুয়াতেমালা: লিবরে ক্রেজকা ফেকুন্ডো (স্পেনীয়: স্বাধীন ও মাথা উঁচু করে বেড়ে উঠুন)
 গেনসি: সরকারি কোন নীতিবাক্য নেই।
 গিনি: ট্রাভেইল, জাস্টিস, সলিডারেট (ফরাসি, কাজ, ন্যায়বিচার, সংহতি)
 গিনি-বিসাউ: ইউনিদাদে, লুটা, প্রোগ্রেসো (পর্তুগীজ, ঐক্য, সংগ্রাম, অগ্রগতি)
 গায়ানা: এক ব্যক্তি, এক জাতি, এক সাম্রাজ্য
 গণতান্ত্রিক কঙ্গো প্রজাতন্ত্র: জাস্টিস - পাইক্স - ট্রাভেইল (ফরাসি, ন্যায়বিচার, শান্তি, কাজ)

চ

 চাদ: ইউনাইট, ট্রাভেইল, প্রোগ্রেস (ফরাসি, ঐক্য, কাজ, উন্নতি)
 চিলি: পোর লা রাজন ও লা ফুয়েরজা (স্প্যানীয়, করন সহকারে বা বলপূর্বক)
 চীন: সরকারি কোন নীতিবাক্য নেই।
 চভাশিয়া: Чаваш Республики; Чувашская Республика (চুভাস, রাশিয়ান, চোভাস প্রজাতন্ত্র)[তথ্যসূত্র প্রয়োজন]
 চেক প্রজাতন্ত্র: প্রাভদা ভিটেজি (চেক, সত্য জয়ী হয়)
 চেকোস্লোভাকিয়া (১৯১৮–১৯৯৩): প্রাভদা ভিটাজাই! (স্লোভাক), প্রাভদা ভিটেজি! (চেক), ভেরিটাস ভিনসিট (লাতিন), সবগুলোর অর্থ "সত্য জয়ী হয়!"[তথ্যসূত্র প্রয়োজন]

জ

জর্জিয়া (রাষ্ট্র): ძალა ერთობაშია! (জালা এর্টাবাসিয়া) (জর্জিয়ান, একতাই শক্তি)[তথ্যসূত্র প্রয়োজন]
 জার্মানি: সরকারি কোন নীতিবাক্য নেই, সাধারনভাবে ইনিগকেইথ উন্দ রিক্ট উন্দ ফ্রেইহেইত (র্জামান: একতা ও ন্যায়বিচার ও স্বাধীনতা)

 পূর্ব জার্মানি: প্রোলেটেরিয়ার এল্লের লান্ডের, ভেরেনিট উচ! (জার্মান: সাড়া বিশ্বের মুজুরেরা, ঐক্যবদ্ধ!)[তথ্যসূত্র প্রয়োজন]
 জার্মান সাম্রাজ্য: গট মিট উন্স (জার্মান: ঈশ্বর আমাদের সাথে)[তথ্যসূত্র প্রয়োজন]
 নাৎসি জার্মানি: ইন ভক, ইন রিচ, ইন ফুরের (জার্মান: এক মানুষ, এক সাম্রাজ্য, এক নেতা)[তথ্যসূত্র প্রয়োজন]


 জিব্রাল্টার: নালি এক্সপোগনাবিলিস হোস্তি (লাতিন: কোন শত্রু দ্বারা অধিকৃত নয়)[তথ্যসূত্র প্রয়োজন]
 জিবুতি: ইতিক্সাদ, গাডবুনান, আমান এবং ইউনাইট, ইগালিট, পাইক্স (সোমালী ও ফরাসি: একতা, সমতা, শান্তি)
 জামাইকা: অনেকের মধ্যে একজন
 জাপান: সরকারি কোন নীতিবাক্য নেই।

টেমপ্লেট:দেশের উপাত্ত জাপানের সাম্রাজ্য: 八紘一宇 (হাক্কু ইচিও) (জাপানি, "সাড়া বিশ্ব এক ছাদের নিচে")[তথ্যসূত্র প্রয়োজন]


 জার্সি: সরকারি কোন নীতিবাক্য নেই।
 জর্দান: الله، الوطن، المليك (আল্লাহ্‌, আল-ওয়াতান, আল-মালিক) (আরবি, "ঈশ্বর, জন্মভূমি, সার্বভৌম")[তথ্যসূত্র প্রয়োজন]
 জাইর: পাইক্স — জাস্টিস — ট্রাভেইল (ফরাসি, শান্তি - বিচার - কাজ)
 জাম্বিয়া: এক জাম্বিয়া, এক দেশ[তথ্যসূত্র প্রয়োজন]
 জিম্বাবুয়ে: ঐক্য, স্বাধীনতা, কাজ[তথ্যসূত্র প্রয়োজন]

সাবেক: সিট নমিনে দিগনা (লাতিন, সে নামের যোগ্য হতে পারে, ১৯৬৫ থেকে ১৯৭৯ পর্যন্ত)



ট

 টাটারস্তান: বেজ বাল্ডিরাবিজ! (টাটার, আমরা পারব!) (বেসরকারী)[তথ্যসূত্র প্রয়োজন]
 টোগো: ট্রাভ্যাইল, লিবার্টে, পাত্রিয়ে (ফরাসি, কাজ, স্বাধীনতা, স্বদেশ)
 টোকেলাউ: টুকেলাউ মো তে আতুয়া (টুকেলাউয়ান, টুকেলাউ পরাক্রমশালী ঈশ্বরের জন্য)[তথ্যসূত্র প্রয়োজন]
 টোঙ্গা: কো ই ʻঅটুয়া মু টোঙ্গা কো হোকো টফিʻআ (টোঙ্গান, আমি ঈশ্বর ও টোঙ্গার কাছে দায়বদ্ধ)[তথ্যসূত্র প্রয়োজন]
 টার্কস্‌ ও কেইকোস দ্বীপপুঞ্জ: প্রকৃতি দ্বারা সুন্দর ও পছন্দ অনুযায়ী পরিষ্করণ[তথ্যসূত্র প্রয়োজন]
 টুভালু: টুভালু মো তে আতুয়া (টুভালুয়ান, টুভালু পরাক্রমশালীর জন্য)[তথ্যসূত্র প্রয়োজন]

ড

 ডেনমার্ক: রানী দ্বিতীয় মার্গারেথের নীতিবাক্য: গাডস হাজে্‌ল্‌প, ফোকে্‌টস কার্লিগেড, ডেনমার্ক স্টার্কি (ড্যানিশ, ঈশ্বরের সাহায্য, মানুষের প্রেমই, ডেনমার্ক-এর শক্তি) 
 ডোমিনিকা: এপ্রিস বন্দাই, সি’এস্ত লা তের (ফরাসি প্রাদেশিক ভাষা, ঈশ্বরের পর পৃথিবী)
 ডোমিনিকান প্রজাতন্ত্র: দিওস, পাত্রিয়া, লিবার্টেড (স্প্যানিশ, ঈশ্বর, দেশ, লিবার্টি)

ত

 তাজিকিস্তান: সরকারি কোন নীতিবাক্য নেই।
 তানজানিয়া: উরুনা উমুজা (সওয়াহিলি, স্বাধীনতা ও ঐক্য)
 ত্রিনিদাদ ও টোবাগো: আমরা একসাথে অঙ্গিকারবদ্ধ ও একসাথে অর্জন করি।
 ত্রিস্টান দা কুনহা: আমাদের বিশ্বাসই আমাদের শক্তি[তথ্যসূত্র প্রয়োজন]
 তিউনিসিয়া: حرية، نظام، عدالة (হুরিয়া, নিজাম,ʿআদালা) (আরবি, মক্তি, আদেশ, ন্যায়বিচার)
 তুরস্ক: ইগেম্যানলিক কেইটসিজ সার্টসিজ মিল্লেটিনডির (তুর্কি, জাতির সাথে স্বাধীন অবলম্বন)
এবং ইয়ার্ত সোল, চিহান্দা সোল (তুর্কী, স্বদেশে শান্তি, বিশ্বে শান্তি) নে মুতলু তুর্কাম দিয়েনি! (তুর্কি, আমি কি সুখী, আমি তুর্কী!)
 তুর্কমেনিস্তান: সরকারি কোন নীতিবাক্য নেই।

থ

 থাইল্যান্ড:

১৮৭৩-১৯১০ : "সাব্বেসাম স্যামগাভুটানাম স্যামাগি ভুদ্দি সাদিকা" (পালি: शब्बेसम् सम्घभुतनम् समग्घि भुद्धि सधिक, "ঐক্য সাফল্য ও সমৃদ্ধি বিষয়ে এনেছে")[তথ্যসূত্র প্রয়োজন]
১৯১০-এর পর : নাই, বেসরকারীভাবে "চ্যাট, সাটসানা, ফ্রা মাহাকাসাট" (থাই: ชาติ ศาสนา พระมหากษัตริย์, "দেশ, ধর্ম, রাজা")



দ

 দক্ষিণ আফ্রিকা: !ke e: /xarra //ke (/Xam, বিভিন্ন মানুষ ঐক্যবদ্ধ বা ডাইভারসিটির মধ্যে ঐক্য)

 দক্ষিণ আফ্রিকার ইউনিয়ন: এক্স ইউনিতাতে ভাইরেস (লাতিন, একতা থেকেই শক্তি)[তথ্যসূত্র প্রয়োজন]


টেমপ্লেট:দেশের উপাত্ত দক্ষিণ জর্জিয়া ও দক্ষিণ স্যান্ডউইচ দ্বীপপুঞ্জ: লিও তেরাম প্রোপিয়াম প্রোগিতাম (লাতিন: "সিংহকে তার ভূমি রক্ষা করতে দাও")[তথ্যসূত্র প্রয়োজন]
 দক্ষিণ সুদান: ন্যায়বিচার, স্বধীনতা, সমৃদ্ধি[তথ্যসূত্র প্রয়োজন]

ন


 নামিবিয়া: ঐক্য, স্বাধীনতা, ন্যায়বিচার
 নাউরু: ঈশ্বরের ইচ্ছায় সর্বাগ্রে[তথ্যসূত্র প্রয়োজন]
   নেপাল: जननी जन्मभूमिष्च स्वर्गादपि गरियसि (সংস্কৃত, "মা ও জন্মভূমি স্বর্গ চেয়ে অনেক বেশি মহান")[তথ্যসূত্র প্রয়োজন]
 নেদারল্যান্ডস: দে মেইনট্রেনডাই; ইক জাল হ্যান্ডহেভেন (ফরাসি; ওলন্দাজ: "আমি কথা রাখব")
 নেদারল্যান্ডস অ্যান্টিল্লেস: লিবার্টেড ইউনিনেমাস, (লাতিন,একতাতেই মুক্তি)
 নিউ ক্যালিডোনিয়া: তেরে দে পারোল,তেরে দে পার্তাগি (ফরাসি, কথা রাখার ভূমি, পৃথিবীতে ভাগ করে বসবাস)[তথ্যসূত্র প্রয়োজন]
 নিউফাউন্ডল্যান্ড: কুয়ারটাইট প্রাইম রেগনাম দেই (লাতিন, প্রথম ঈশ্বরের রাজত্ব তোমরা খোঁজ)[তথ্যসূত্র প্রয়োজন]
 নিউজিল্যান্ড: নাই, সাবেক বর্ধনশীল
 নিকারাগুয়া: এনদিওস কনফিয়ামোস (স্প্যানীয়, আমরা ঈশ্বরে বিশ্বাসী)
 নাইজার: ফ্রাটারনাইট, ট্রাভেইল, প্রোগ্রেস (ফরাসি, ভ্রাতৃত্ব, কাজ, অগ্রগতি)
 নাইজেরিয়া: একতা ও বিশ্বাস, শান্তি ও প্রগতি
 নিউই: সরকারি কোন নীতিবাক্য নেই।
 উত্তর বোর্নিও: পেরগু এট পেরাগু (লাতিন, আমি দায়িত্বগ্রহণ করি এবং তা আমি অর্জন করি)[তথ্যসূত্র প্রয়োজন]
 উত্তর মারিয়ানা দ্বীপপুঞ্জ: সরকারি কোন নীতিবাক্য নেই।
 নরওয়ে: রাজকীয় নীতিবাক্য: আল্ট ফর নর্গে (নরওয়েজিয়ান, সবকিছু নরওয়ের জন্য) ও ইডসভল শপথ: এনিজি অগ ট্রুই, ইন্ডটিল ডোবরে ফালদার (নরওয়েজিয়ান, ডোবরে পাহাড় চূর্ণ হওয়া পর্যন্ত ঐক্যবদ্ধ থাকব)[তথ্যসূত্র প্রয়োজন]

প



 পাকিস্তান: ايمان، اتحاد، نظم (উর্দু, "বিশ্বাস, ঐক্য, শৃঙ্খলা")
 পালাউ: পালাউ প্রজাতন্ত্র[তথ্যসূত্র প্রয়োজন]
 পানামা: প্রু মুন্ডি বেনিফিসিও (লাতিন, বিশ্বের কল্যাণের জন্য)
 পাপুয়া নিউ গিনি: বিভিন্নতা ঐক্য[তথ্যসূত্র প্রয়োজন]
 প্যারাগুয়ে: পাজ ইয়ে জাস্টিসিয়া (স্প্যানীয়, শান্তি ও ন্যায়বিচার)
 পেরু: ফার্মি ইয়ে ফেলিজ পর লা ইউনিয়ন (স্প্যানীয়, "ইউনিয়নের জন্য দৃঢ় ও সুখী")[তথ্যসূত্র প্রয়োজন]
 পোল্যান্ড: সরকারি কোন নীতিবাক্য নেই। বেসরকারী নীতিবাক্য: জা ওলনস্ক জালজা আই ওয়াজা (পোলিশ, "আমাদের ও তোমাদের মুক্তির জন্য"); ও বোগ, অনার, ওজেজিজনা (ঈশ্বর, সম্মান, জন্মভূমি)।
 পর্তুগাল: সরকারি কোন নীতিবাক্য নেই।

সমরিক নীতিবাক্য: "ইস্তা ই য়া দিতোসা পাত্রিয়া মিনহা আমাদা" ("এটা আমার মাতৃভূমি, আমার ভালোবাসা") — ওস লাসিয়াদাস থেকে।
 পর্তুগাল রাজ্য: ইন হোক সিগনো ভিন্সিস (লাতিন, "এই মন্ত্রে আপনি বশীভূত হবেন")
ইস্তাদো নোভো: "অরগুহোসামেন্তে সস" (ওলন্দাজ,"একাই সম্মানীত")


 প্রুশিয়া: "সাম কুইকু" (লাতিন: "সবই তার ইচ্ছা") ১৫২৫-১৯৪৭
 পুয়ের্তো রিকো: জুয়ানিস ইস্ট নমিন ইজাস (লাতিন, "জন তার নাম")[তথ্যসূত্র প্রয়োজন]
 পূর্ব টিমোর: অনরা, পাত্রিয়া ই পোভো (পর্তুগীজ, সম্মান,স্বদেশ এবং মানুষ)

ফ

ফকল্যান্ড দ্বীপপুঞ্জ: সঠিক আকাঙ্খা
 ফারো দ্বীপপুঞ্জ: সরকারি কোন নীতিবাক্য নেই।
 ফিজি: রিরেভাকা না কালো কা দুকা না তুই (ফিজি, ঈশ্বরকে ভয় কর ও রাণীকে সম্মান কর)
 ফিনল্যান্ড: সরকারি কোন নীতিবাক্য নেই।
 ফ্রান্স: লিবার্টি, ইগালিটি, ফ্রাটারনাইট (ফরাসি, স্বাধীনতা, সমতা, ভ্রাতৃত্ব)

Vichy France: [[ট্রাভেইল, ফ্যামেলি, পাত্রিয়া (ফরাসি: কাজ, পরিবার, জন্মভূমি)[তথ্যসূত্র প্রয়োজন]


 ফরাসি পলিনেশিয়া: তাহিতি নাই মারেআরেয়া (তাহিতিয়ান, স্বর্ণালোকে মহান পলিনেশিয়া)[তথ্যসূত্র প্রয়োজন]

 ফিলিপাইন (ফোর্থ প্রজাতন্ত্র): ইসাঙ বানসা, ইসাঙ দিওয়া (ফিলিপিনো: "এক দেশ, এক আত্মা")। ১৯৮৬ সালের পর জনগণের আন্দোলনে ভেঙ্গে পরে।[তথ্যসূত্র প্রয়োজন]


 ফিলিপাইন: মাকা-দিওস, মাকা-টাও, মাকাকালিকাসান অ্যাট মাকাবানসা (তাগালগ, ঈশ্বরের জন্য, মানুষ, প্রকৃতি ও দেশ)

ব



 বাহামা দ্বীপপুঞ্জ: সম্মুখদিকে, ঊর্ধ্বাভিমুখে একসঙ্গে
 বাহরাইন: সরকারি কোন নীতিবাক্য নেই।
 বাংলাদেশ: জয় বাংলা
 বার্বাডোস: গর্ব এবং শিল্প
 বাভারিয়া: সাবেক, ইন ট্রুই ফেস্ট (র্জামান, অপলক আনুগত্য)[তথ্যসূত্র প্রয়োজন]
 বেলারুশ: সরকারি কোন নীতিবাক্য নেই।
 বেলজিয়াম: এনড্রাচ মাক্‌ট মাচ, এল’ইউনিয়ন ফেইট লা ফোর্স এবং ইনিগকেইটজিবতস্টারকে (ওলন্দাজ, ফরাসি ও জার্মান, একতাই শক্তি)
 বেলিজ: সাব আম্ব্রা ফ্লোরিও (লাতিন, আলোকছায়ার অধীন আমি ঝঞ্ঝা)
 বেনিন: ফ্রাটেরনাইট, জাস্টিস, ট্রাভেইল (ফরাসি, ফেলোশিপ, বিচার, শ্রম)
 বারমুডা: ক্যু ফাতা ফেরান্ত (লাতিন: গ্রীক নিয়তিদেবী আমাদের যেখানে বহন করেন)
বিআফ্রা প্রজাতন্ত্র: শান্তি, ঐক্য, স্বাধীনতা[তথ্যসূত্র প্রয়োজন]
 বলিভিয়া: লা ইউনিয়ন ইস লা ফুয়েরজা (স্প্যানীয়, ঐক্যই শক্তি)
 বসনিয়া ও হার্জেগোভিনা: সরকারি কোন নীতিবাক্য নেই।
 বতসোয়ানা: পুলা (তিএসওয়ানা, বৃষ্টি)
 ব্রাজিল: ওর্দেম ই প্রোগ্রেসো (পর্তুগীজ, আদেশ এবং অগ্রগতি)

 ব্রাজিলের সাম্রাজ্য: ইন্ডিপেন্ডেনসিয়া ও মর্তে! (পর্তুগীজ, স্বাধীনতা অথবা মৃত্যু!)[তথ্যসূত্র প্রয়োজন]


 ব্রিটিশ দক্ষিণ মেরুদেশীয় অঞ্চল: গবেষণা ও আবিষ্কার[তথ্যসূত্র প্রয়োজন]
 ব্রিটিশ ভারত মহাসাগরীয় অঞ্চল: ইন তুঁতেলা নস্ত্রা লিমুরিয়া (লাতিন: "লিমুরিয়াই আমাদের শক্তি")[তথ্যসূত্র প্রয়োজন]
 ব্রিটিশ ভার্জিন দ্বীপপুঞ্জ: ভিজিলেট (লাতিন: বিনিদ্র হও)[তথ্যসূত্র প্রয়োজন]
 ব্রুনাই: الدائمون المحسنون بالهدى (আরবি, সর্বদা ঈশ্বরের নির্দেশিকা অনুসারে সেবা)
 বুলগেরিয়া: Съединението прави силата (বুলগেরিয়ান, একতাই শক্তি)
 বুর্কিনা ফাসো: ইউনাইট, প্রোগ্রেস, জাস্টিস (ফরাসি, ঐক্য, অগ্রগতি, বিচার)
 বুরুন্ডি: ইউনাইট, ট্রাভেইল, জাস্টিস (ফরাসি, ঐক্য, কাজ, বিচার)
 বিষুবীয় গিনি: ইউনিদাদ, পাজ, জাস্টিসিয়া (স্প্যানিশ, ঐক্য, শান্তি, ন্যায়বিচার)[তথ্যসূত্র প্রয়োজন]

ভ


 ভারত: सत्यमेव जयते (সত্যমেব জয়তে) (সংস্কৃত ভাষা, সত্যের জয় অবশ্যম্ভাবী)
 ভূটান: সরকারি কোন নীতিবাক্য নেই।
 ভানুয়াটু: লং গড ইয়ামি স্টানাপ (বিসলামা, ঈশ্বরে বিশ্বাস রাখা যাক)
 ভ্যাটিকান সিটি: সরকারি কোন নীতিবাক্য নেই।
 ভেনেজুয়েলা: ঐতিহাসিক: ডায়স ইয়ে ফেডারেসিওন (স্প্যানীশ, ঈশ্বর এবং ফেডারেশন)[তথ্যসূত্র প্রয়োজন]
 ভিয়েতনাম: ডক লাপ, টু ডু, হানাহ্‌ পুক (ভিয়েতনামীজ, স্বাধীনতা, স্বাধীনতা এবং সুখ)[তথ্যসূত্র প্রয়োজন]

 দক্ষিণ ভিয়েতনাম: ১৯৫৪-৬৭: তু কুক, ডানহ্‌ দু, ট্রাক নিয়েম (ভিয়েতনামীজ, জন্মভূমি, সম্মান, দায়িত্ব); ১৯৬৭-৭৫: তু কুক, কং মি, লিয়েম চিন (ভিয়েতনামীজ, জন্মভূমি, বিচার, সততা)[তথ্যসূত্র প্রয়োজন]



ম

 ম্যাসেডোনিয়া: সরকারি কোন নীতিবাক্য নেই, ঐতিহ্যগত: Слобода или Смрт (ম্যাসেডোনিয়ান, স্লোবোদা ইলি স্মর্ট, স্বাধীনতা অথবা মৃত্যু)
 মাদাগাস্কার: ফিটিয়াভানা, তানিনদ্রাজানা, ফান্ডরোসোয়ানা (মালাগাছি, ভালবাসা, পূর্বপুরুষের জমিতে, অগ্রগতি)
 মাদিরা: দাশ ইলহাস, এজ মাইস বেলাস ই লিভারস (পর্তুগীজ, সবচেয়ে সুন্দর ও মুক্ত দ্বীপপুঞ্জ)[তথ্যসূত্র প্রয়োজন]
 মালাউই: একতা ও মুক্তি[তথ্যসূত্র প্রয়োজন]
 মালয়েশিয়া: বেরসেকুটু বার্থাম্বা মুটু (মালয়, একতাই শক্তি)
 মালদ্বীপ: الدولة ا۔لحلدݐبݐة (আল-দৌলাত আল-মালদেবিয়া) (আরবি, মালদ্বীপ রাষ্ট্র)[তথ্যসূত্র প্রয়োজন]
 মালি: আন পিপ্যুল, আন বাট, উনি ফ্যুই (ফরাসি, এক জাতি, এক উদ্দেশ্য, এক বিশ্বাস)
 মাল্টা: ভার্টুটে এট কন্সটানটিয়া (লাতিন, শক্তি এবং দৃঢ়তা)[তথ্যসূত্র প্রয়োজন]
 মার্শাল দ্বীপপুঞ্জ: জেপিলপিলিন কে ইজুকানা (মার্শালী, যৌথ প্রচেষ্টার মাধ্যমে অর্জন)[তথ্যসূত্র প্রয়োজন]
 মৌরিতানিয়া: شرف، إخاء، عدالة বা অনের, ফ্রাটারনাইট, জাস্টিস (আরবি এবং ফরাসি, সম্মান, ভ্রাতৃত্ব, ন্যায়বিচার)
 মরিশাস: স্টেল্লা ক্লাভিসকু মারিস ইন্ডিকি (লাতিন, ভারত মহাসাগরের উল্লেখযোগ্য ও উজ্জল নক্ষত্র)
 মেক্সিকো: সরকারি কোন নীতিবাক্য নেই। যাইহোক, সাফরাজিও ইফেক্টিও, নো রিইলেকসন ইজ অফেন ইউজ্ড (স্প্যানীয়, কার্যকরী ভোটাধিকার, কোন পুনর্নির্বাচন দরকার নেই)
 মাইক্রোনেশিয়া যুক্তরাজ্য: শান্তি, ঐক্য, লিবার্টি[তথ্যসূত্র প্রয়োজন]
 মলদোভা: লিম্বা নুয়াস্ট্রা-ই ও কুমুয়ারা (রোমানিয়ান, আমাদের ভাষাই, আমাদের সম্পদ)
 মোনাকো: দিও জুভান্তি (লাতিন, ঈশ্বরের সাহায্যে)
 মঙ্গোলিয়া: সরকারি কোন নীতিবাক্য নেই।
 মন্টিনিগ্রো: সরকারি কোন নীতিবাক্য নেই।
 মন্টসেরাট: প্রত্যেক উদ্যোগী ও সমস্ত অর্জন[তথ্যসূত্র প্রয়োজন]
টেমপ্লেট:দেশের উপাত্ত মরোক্কো: الله، الوطن، الملك (আল্লাহ্‌, আল-ওয়াতান, আল-মালিক) (আরবি, আল্লাহ্‌, দেশ, রাজা)

রাজকীয় নীতিবাক্য: إن تذصروا الڷه ݐذصر کم (আরবি, আপনি আল্লাহ্‌র কীর্তন করুন, তাহলে তিনি আপনার কীর্তন করবে)[তথ্যসূত্র প্রয়োজন]


 মোজাম্বিক: রিপাবলিকা দে মোকাম্বিকো (পর্তুগীজ, মোজাম্বিক প্রজাতন্ত্র)[তথ্যসূত্র প্রয়োজন]
 মধ্য আফ্রিকান প্রজাতন্ত্র: ইউনাইট, ডিগনাইট, ট্রাভেইল (ফরাসি, ঐক্য, মর্যাদা, কাজ)
 মার্কিন যুক্তরাষ্ট্র: আমরা ঈশ্বরে বিশ্বাস করি (সরকারি), ই প্লুরিবাস উনুম (ঐতিহ্যবাহী)
 মার্কিন ভার্জিন দ্বীপপুঞ্জ: অত্মবিশ্বাস ও গর্বিত একতা[তথ্যসূত্র প্রয়োজন]

য

 যুক্তরাজ্য: দিও এট্র মন দ্রয়িট (ফরাসি, ঈশ্বর এবং আমার অধিকার)

র



 রোদেসিয়া: সিট নমিনে দিগনা (লাতিন, সে নামের যোগ্য হতে পারে)[তথ্যসূত্র প্রয়োজন]


রোমান প্রজাতন্ত্র ও রোমান সাম্রাজ্য: সেনাতুস পুপুলাস রোমানকু (লাতিন, সিনেটও রোমের জনগণ)
 রোমানিয়া: সাবেক নিহিল সাইনি দেও (লাতিন, ঈশ্বর ছাড়া কিছুই করার নেই) এবং আরো পূর্বে টোটি ইন উনো (রোমানিয়ান, একের ভিতর সব)[তথ্যসূত্র প্রয়োজন]। বর্তমানে নেই।
 রাশিয়া: কোন সরকারি নীতিবাক্য নেই।

রাশিয়া সাম্রাজ্য: Съ Нами Богъ (এস নামি বগ) (রাশিয়ান, ঈশ্বর আমাদের সাথে আছেন)[তথ্যসূত্র প্রয়োজন]


 রুয়ান্ডা: ওবুমওই, ওমুরিমো, গুকুন্ডা আইগিহুগু (কিনিয়ারোয়ান্ডা, ঐক্য, কাজ, দেশপ্রেম)

ল

 লাওস: "ສັນຕິພາບ ເອກະລາດ ປະຊາທິປະໄຕ ເອກະພາບ ວັດທະນາຖາວອນ" (লাও, শান্তি, স্বাধীনতা, গণতন্ত্র, একতা ও সমৃদ্ধি)
 লাতভিয়া: টেভজেমি আন ব্রাইভিবাই (লাতভিয়ান, স্বদেশ, স্বাধীনতা)[তথ্যসূত্র প্রয়োজন]
 লেবানন: كلنا للوطن ،، للعلا للعلم (আরবি, আমরা সকলেই দেশ ও পতাকার জন্য মহীয়ান)[তথ্যসূত্র প্রয়োজন]
 লেসোথো: খতসো, পুলা, নালা (সুথো, শান্তি, বৃষ্টি, সমৃদ্ধি)
 লাইবেরিয়া: স্বাধীনতার ভালবাসাই আমাদের এখানে এনেছে
 লিবিয়া: স্বাধীনতা, ন্যায়বিচার, গণতন্ত্র[তথ্যসূত্র প্রয়োজন]
টেমপ্লেট:দেশের উপাত্ত লিশটেনস্টাইন: ফুর গট, ফুর্স্ট আন্দ ভেতেরল্যান্ড (জার্মান, ঈশ্বর, প্রিন্স এবং জন্মভুমি জন্য)[তথ্যসূত্র প্রয়োজন]
 লিথুয়ানিয়া: তাউতুস জেগা ভিয়ানিভেজি (লিথুয়ানিয়ান, জাতির শক্তি, একতা এই ব্যবস্থার সবচেয়ে গুরত্বপূর্ণ বিষয়)[তথ্যসূত্র প্রয়োজন]
 লুক্সেমবুর্গ: মির উল্লি বেলউই ওয়াট মির সিন (লুক্সেমবুর্গিস, আমরা যা, তাই থাকতে চাই)

শ

 শ্রীলঙ্কা: সরকারি কোন নীতিবাক্য নেই।

স

 সারায়ুই আরব গণতান্ত্রিক প্রজাতন্ত্র: حرية ديمقراطية وحدة (হুরাইয়া ডিমুক্রেটিয়া ওয়াহদা) (আরবি, স্বাধীনতা, গণতন্ত্র, একতা)[তথ্যসূত্র প্রয়োজন]
 সেন্ট হেলেনা: বিশ্বস্ত এবং দৃঢ়[তথ্যসূত্র প্রয়োজন]
 সেন্ট কিট্‌স ও নেভিস: স্বয়ংসম্পূর্ণ রাষ্ট্র
 সেন্ট লুসিয়া: জমি, মানুষ, আলো
 সেন্ট ভিনসেন্ট ও গ্রেনাডাইন দ্বীপপুঞ্জ: প্যাক্স এট জাস্টিটিয়া (লাতিন, শান্তি ও ন্যায়বিচার)
 সাখা প্রজাতন্ত্র: Республика Саха; Саха Республиката (রাশিয়ান, সাখা, সাখা প্রজাতন্ত্র)[তথ্যসূত্র প্রয়োজন]
 সামোয়া: ফায়া’ভাই আই লে আতুয়া সামোয়া (সামোয়ান, ঈশ্বরই সামোয়ার একমাত্র সংস্থাপক)
 সান মারিনো: লিবার্টাস (লাতিন, স্বাধীনতা)[তথ্যসূত্র প্রয়োজন]
 সাঁউ তুমি ও প্রিন্সিপি: ইউনিদাদে, ডিসিপ্লিনা, ট্রাভালহো (পর্তুগীজ, "ঐক্য, শৃঙ্খলা, কাজ")[তথ্যসূত্র প্রয়োজন]
 সারাওয়াক রাজ্য: দুম স্পাইরো, স্প্যারো (লাতিন, "যখন আমি নিঃশ্বাস নেই, তখন আমার আশাও বেঁচে থাকে")[তথ্যসূত্র প্রয়োজন]
 সৌদি আরব: لا إله إلا الله محمد رسول الله (লা ইলাহা ইল্লালা, মুহাম্মাদুর রসুল্লুলা) (আরবি, "আল্লাহ ব্যতীত কোন মাবুদ নাই, মুহাম্মদ (সঃ) তাঁর প্রেরিত নবী")
 স্কটল্যান্ড: আমার পক্ষে ঈশ্বরই আমাকে রক্ষা করবেন এবং নেমু মি ইমপুনে লাসিসিট (লাতিন, কেই আমাকে শাস্তির জন্য প্ররোচিত করতে পারে না)
 সেনেগাল: আন পিপ্যুল, আন বাট, আনি ফুই (ফরাসি, একজন মানুষ, একটি লক্ষ্য ও এক বিশ্বাস)
 সার্বিয়া: সরকারি কোন নীতিবাক্য নেই।
 সেশেল: ফিনিশ করুনাট ওপাস (লাতিন, শেষ মুকুট কাজ)[তথ্যসূত্র প্রয়োজন]
 সিয়েরা লিওন: একতা, মুক্তি ও ন্যায়বিচার
 সিকিম: "খাম-সুম-অংদু" (তিব্বতি, তিন পৃথিবীর বিজেতা)[তথ্যসূত্র প্রয়োজন]
 সিঙ্গাপুর: মাজুলা সিঙ্গাপুরা (মালয়, অনওয়ার্ড সিঙ্গাপুর)[তথ্যসূত্র প্রয়োজন]
 সিন্ট মারর্টেন: সেমপের প্রো গ্রেডিয়েন্স (লাতিন, সর্বদা উন্নতিশীল)[তথ্যসূত্র প্রয়োজন]
 স্লোভাকিয়া: ভেরনি সেভে, ভর্নি নেপরেড! (স্লোভাক), এগিয়ে, একসঙ্গে নিজেদের বিশ্বাসী! (১৯৩৯-১৯৪৫)[তথ্যসূত্র প্রয়োজন]
 স্লোভেনিয়া: সরকারি কোন নীতিবাক্য নেই।
 সলোমন দ্বীপপুঞ্জ: সেবার নেতৃত্ব[তথ্যসূত্র প্রয়োজন]
 সোমালিয়া: এগিয়ে যান, এবং কখনও অনগ্রসর হবেন না
 সোভিয়েত ইউনিয়ন: Пролетарии всех стран, соединяйтесь! (রাশিয়ান, পৃথিবীর সকল দরিদ্র ব্যক্তিরা একসঙ্গে!) (অন্যান্য চৌদ্দ প্রজাতন্ত্রগুলির এর ভাষায় অনূদিত)
 স্পেন: প্লাস আল্ট্রা (লাতিন, তার পরেও আরও)

সাবেক: উনা, গ্রেনদি ইয়ে লিবরে (স্প্যানীয়, এক, মহান ও মুক্তি)


 সুদান: النصر لنا (আন-নাসর লিনা): আরবি, বিজয় আমাদের)
 সুরিনাম: জাস্টিটিয়া, পিতাস, ফিদেস (লাতিন, ন্যায়বিচার, ভক্তি, আনুগত্য)
 সোয়াজিল্যান্ড: সিনকাবা (সুয়াতি, আমরাই দুর্গ)
 সুইডেন: রাজকীয় নীতিবাক্য: ফর ভেরিজ - ই তাইদেন (সুইডিস, সময় সহ - সুইডেন জন্য) (See all royal mottos)
 সুইজারল্যান্ড: আনাস প্রো অমনিবাস, উমনেস প্রো উনু (লাতিন, একজনের জন্য সবাই, সকলের জন্য একজন)
 সিরিয়া: وحدة ، حرية ، اشتراكية (ওয়াদাহ্‌, হুরিয়া, ইস্তিরাকিয়া) (আরবি, ঐক্য, স্বাধীনতা, সমাজতন্ত্র) Ba'ath Party[তথ্যসূত্র প্রয়োজন]
 সংযুক্ত আরব আমিরাত: الله , الوطن , الرئيس (আল্লাহ্‌, আল-ওয়াতান, আল-রাইস) (আরবি, আল্লাহ্‌, জাতি, রাষ্ট্রপতি)[তথ্যসূত্র প্রয়োজন]
 সাইপ্রাস: সরকারি কোন নীতিবাক্য নেই।

হ

 হাইতি: এল’ইউনিয়ন ফেইত লা ফোর্স (ফরাসি, একতাই শক্তি)
 হাওয়াই রাজ্য: উয়া মাউ কে ইয়া ও কা ʻআইনা আই কা পুনো (হাওয়াই, জমির দ্বায়িত্ব ন্যায়বিচারের মাধ্যমে)[তথ্যসূত্র প্রয়োজন]
 হন্ডুরাস: লাইব্রে, সোবেরানাই ইন্ডেপেন্ডেন্টি (স্প্যানিশ, মুক্ত, সার্বভৌম ও স্বাধীন)
 ব্রিটিশ হংকং: দিউ এট মন দ্রোইট (ফরাসি, ঈম্বর এবং আমার অধিকার)[তথ্যসূত্র প্রয়োজন]
 হাঙ্গেরি: সাবেক কাম দিও প্রো পাত্রিয়া এট লিবার্টেট (লাতিন, "ঈম্বরের সাহায্যে স্বদেশ ও স্বাধীনতা")[তথ্যসূত্র প্রয়োজন], ইস্তেন আলাদ মেগ অ্য ম্যাগেয়িার্ট! (হাঙ্গেরিয়ান, "ঈশ্বর হঙ্গেরিয়দের মঙ্গল করুন!") ২০১১ সংবিধান অনুসারে, সরকারি নয়।

তথ্যসূত্র



↑ As shown on the 1908 coat of arms of Australia
↑ As shown on the coat of arms.
↑ । সংগ্রহের তারিখ ২০০৬-০৮-০৩। উদ্ধৃতি টেমপ্লেট ইংরেজি প্যারামিটার ব্যবহার করেছে (link) (আরবি)
↑ । সংগ্রহের তারিখ ২০১৮-০৪-১৬। উদ্ধৃতি টেমপ্লেট ইংরেজি প্যারামিটার ব্যবহার করেছে (link) (ইংরেজি)
↑ । ২০০৬-০৭-১৪ তারিখে  থেকে আর্কাইভ করা। সংগ্রহের তারিখ ২০০৬-০৮-০২। উদ্ধৃতি টেমপ্লেট ইংরেজি প্যারামিটার ব্যবহার করেছে (link) (ফরাসি)
↑ । সংগ্রহের তারিখ ২০০৬-০৮-০২। উদ্ধৃতি টেমপ্লেট ইংরেজি প্যারামিটার ব্যবহার করেছে (link)
↑ As shown on the back of coins; see for instance this photo of a 1992 25 centavos coin.
↑ 
↑ ক খ As shown on the Coat of arms of Sint Maarten
↑ । সংগ্রহের তারিখ ২০১০-০১-২৩। উদ্ধৃতি টেমপ্লেট ইংরেজি প্যারামিটার ব্যবহার করেছে (link)
↑ । সংগ্রহের তারিখ ২০০৬-০৮-১৫। উদ্ধৃতি টেমপ্লেট ইংরেজি প্যারামিটার ব্যবহার করেছে (link)
↑ Article 36A of the Constitution of the Republic of Indonesia
↑ 
↑ Article 18 of  states that "The Official Flag of Iran is composed of green, white, and red colors, with the special emblem of the Islamic Republic, together with the State Motto."
↑ । সংগ্রহের তারিখ ২০০৭-০৫-০৩। উদ্ধৃতি টেমপ্লেট ইংরেজি প্যারামিটার ব্যবহার করেছে (link)
↑ As shown on the flag of Iraq.
↑ । ২০০৮-০১-১৬ তারিখে  থেকে আর্কাইভ করা। সংগ্রহের তারিখ ২০০৬-০৮-২৭। উদ্ধৃতি টেমপ্লেট ইংরেজি প্যারামিটার ব্যবহার করেছে (link)
↑ । সংগ্রহের তারিখ ২০০৬-১০-২৮। উদ্ধৃতি টেমপ্লেট ইংরেজি প্যারামিটার ব্যবহার করেছে (link)
↑ । ২০০৬-০৮-১৭ তারিখে  থেকে আর্কাইভ করা। সংগ্রহের তারিখ ২০০৬-০৮-১৪। উদ্ধৃতি টেমপ্লেট ইংরেজি প্যারামিটার ব্যবহার করেছে (link) (স্পেনীয়)
↑ । সংগ্রহের তারিখ ২০১১-০৪-১৩। উদ্ধৃতি টেমপ্লেট ইংরেজি প্যারামিটার ব্যবহার করেছে (link)
↑ । সংগ্রহের তারিখ ২০০৬-০৮-০৫।  ইউআরএল–উইকিসংযোগ দ্বন্দ্ব (সাহায্য)উদ্ধৃতি টেমপ্লেট ইংরেজি প্যারামিটার ব্যবহার করেছে (link)
↑ । সংগ্রহের তারিখ ২০০৬-০৮-০৫। উদ্ধৃতি টেমপ্লেট ইংরেজি প্যারামিটার ব্যবহার করেছে (link)
↑ As shown on the seal of the Confederate States of America.
↑  (PDF)। সংগ্রহের তারিখ ২০০৬-০৮-০৮। উদ্ধৃতি টেমপ্লেট ইংরেজি প্যারামিটার ব্যবহার করেছে (link) (ফরাসি)
↑ । সংগ্রহের তারিখ ২০০৬-০৮-০৮। উদ্ধৃতি টেমপ্লেট ইংরেজি প্যারামিটার ব্যবহার করেছে (link) (ফরাসি)
↑ As shown on the obverse of the coins; see । সংগ্রহের তারিখ ২০০৬-০৯-২৬। উদ্ধৃতি টেমপ্লেট ইংরেজি প্যারামিটার ব্যবহার করেছে (link)
↑  (PDF)। সংগ্রহের তারিখ ২০০৮-০১-১৯। উদ্ধৃতি টেমপ্লেট ইংরেজি প্যারামিটার ব্যবহার করেছে (link)
↑ । ২০০৭-১০-০৭ তারিখে  থেকে আর্কাইভ করা। সংগ্রহের তারিখ ২০০৬-০৮-১৫। উদ্ধৃতি টেমপ্লেট ইংরেজি প্যারামিটার ব্যবহার করেছে (link)
↑ । ২০০৬-০৪-১৪ তারিখে  থেকে আর্কাইভ করা। সংগ্রহের তারিখ ২০০৬-০৮-১৬। উদ্ধৃতি টেমপ্লেট ইংরেজি প্যারামিটার ব্যবহার করেছে (link)
↑ । সংগ্রহের তারিখ ২০০৬-০৮-০২। উদ্ধৃতি টেমপ্লেট ইংরেজি প্যারামিটার ব্যবহার করেছে (link)
↑ । সংগ্রহের তারিখ ২০০৮-০৩-১১। উদ্ধৃতি টেমপ্লেট ইংরেজি প্যারামিটার ব্যবহার করেছে (link)
↑ । সংগ্রহের তারিখ ২০০৬-০৮-২২। উদ্ধৃতি টেমপ্লেট ইংরেজি প্যারামিটার ব্যবহার করেছে (link) [অকার্যকর সংযোগ](ফরাসি)
↑ Article 21 of । সংগ্রহের তারিখ ২০০৬-০৮-২২। উদ্ধৃতি টেমপ্লেট ইংরেজি প্যারামিটার ব্যবহার করেছে (link) (ফরাসি)
↑ । সংগ্রহের তারিখ ২০০৬-০৮-০২। উদ্ধৃতি টেমপ্লেট ইংরেজি প্যারামিটার ব্যবহার করেছে (link)
↑ । সংগ্রহের তারিখ ২০০৬-০৮-০৮। উদ্ধৃতি টেমপ্লেট ইংরেজি প্যারামিটার ব্যবহার করেছে (link) (ফরাসি)
↑ । ২০০৬-০৮-০৫ তারিখে  থেকে আর্কাইভ করা। সংগ্রহের তারিখ ২০০৬-০৮-০৮। উদ্ধৃতি টেমপ্লেট ইংরেজি প্যারামিটার ব্যবহার করেছে (link) (ফরাসি)
↑ Gobierno de Chile।  (Spanish ভাষায়)। সংগ্রহের তারিখ ২১ জুলাই ২০১৫। উদ্ধৃতি টেমপ্লেট ইংরেজি প্যারামিটার ব্যবহার করেছে (link) উদ্ধৃতি শৈলী রক্ষণাবেক্ষণ: অচেনা ভাষা (link)
↑ As shown on the Flag of the president of the Czech Republic
↑ । সংগ্রহের তারিখ ২০০৬-০৮-০৮। উদ্ধৃতি টেমপ্লেট ইংরেজি প্যারামিটার ব্যবহার করেছে (link) (ফরাসি)
↑ 
↑ Constitution de la République du Zaïre, article 5: “Sa devise est : Paix — Justice — Travail”. Source: Journal Officiel de la République du Zaïre (N. 1 du 1er janvier 1983)
↑ । ২০০৭-০১-০৪ তারিখে  থেকে আর্কাইভ করা। সংগ্রহের তারিখ ২০০৬-০৮-২৭। উদ্ধৃতি টেমপ্লেট ইংরেজি প্যারামিটার ব্যবহার করেছে (link) (ফরাসি)
↑  (ইংরেজি ভাষায়)। ২০১৩-১০-২৫ তারিখে  থেকে আর্কাইভ করা। সংগ্রহের তারিখ ২০১৮-০৪-১৬। উদ্ধৃতি টেমপ্লেট ইংরেজি প্যারামিটার ব্যবহার করেছে (link)
↑ । সংগ্রহের তারিখ ২০০৬-০৮-০২। উদ্ধৃতি টেমপ্লেট ইংরেজি প্যারামিটার ব্যবহার করেছে (link)
↑ Article 93 of । সংগ্রহের তারিখ ২০০৬-০৮-০৫। উদ্ধৃতি টেমপ্লেট ইংরেজি প্যারামিটার ব্যবহার করেছে (link) (স্পেনীয়)
↑ । সংগ্রহের তারিখ ২০০৬-০৮-০২। উদ্ধৃতি টেমপ্লেট ইংরেজি প্যারামিটার ব্যবহার করেছে (link)
↑ । সংগ্রহের তারিখ ২০০৬-০৮-০২। উদ্ধৃতি টেমপ্লেট ইংরেজি প্যারামিটার ব্যবহার করেছে (link)
↑ । ২০০৬-০৯-৩০ তারিখে  থেকে আর্কাইভ করা। সংগ্রহের তারিখ ২০০৬-০৮-২৩। উদ্ধৃতি টেমপ্লেট ইংরেজি প্যারামিটার ব্যবহার করেছে (link) (ফরাসি)
↑ ক খ । ২০০৭-০১-০৮ তারিখে  থেকে আর্কাইভ করা। সংগ্রহের তারিখ ২০০৭-০১-১১। উদ্ধৃতি টেমপ্লেট ইংরেজি প্যারামিটার ব্যবহার করেছে (link)
↑ । সংগ্রহের তারিখ ২০০৭-০২-০৯। উদ্ধৃতি টেমপ্লেট ইংরেজি প্যারামিটার ব্যবহার করেছে (link)
↑ ชนิดา พรหมพยัคฆ์ เผือกสม, การเมืองในประวัติศาสตร์ธงชาติไทย. กรุงเทพฯ: สำนักพิมพ์มติชน, 2546.
↑ । সংগ্রহের তারিখ ২০০৬-০৮-২৭। উদ্ধৃতি টেমপ্লেট ইংরেজি প্যারামিটার ব্যবহার করেছে (link)
↑ । ২০০৬-০৮-২০ তারিখে  থেকে আর্কাইভ করা। সংগ্রহের তারিখ ২০০৬-০৮-২৩। উদ্ধৃতি টেমপ্লেট ইংরেজি প্যারামিটার ব্যবহার করেছে (link)
↑ ক খ । ২০০৬-০৫-০৭ তারিখে  থেকে আর্কাইভ করা। সংগ্রহের তারিখ ২০০৬-০৮-০২। উদ্ধৃতি টেমপ্লেট ইংরেজি প্যারামিটার ব্যবহার করেছে (link)
↑ । সংগ্রহের তারিখ ২০০৮-০৩-১১। উদ্ধৃতি টেমপ্লেট ইংরেজি প্যারামিটার ব্যবহার করেছে (link)
↑ As shown on the Córdoba (bank notes and coins); see for example 
↑ । সংগ্রহের তারিখ ২০০৬-০৮-২৩। উদ্ধৃতি টেমপ্লেট ইংরেজি প্যারামিটার ব্যবহার করেছে (link) (ফরাসি)
↑ Article 15 of the । সংগ্রহের তারিখ ২০০৬-০৮-২৩। উদ্ধৃতি টেমপ্লেট ইংরেজি প্যারামিটার ব্যবহার করেছে (link)
↑ । সংগ্রহের তারিখ ২০০৬-০৮-০২। উদ্ধৃতি টেমপ্লেট ইংরেজি প্যারামিটার ব্যবহার করেছে (link)
↑ As shown on the Coat of arms of Panama
↑ । সংগ্রহের তারিখ ২০০৬-০৮-২৬। উদ্ধৃতি টেমপ্লেট ইংরেজি প্যারামিটার ব্যবহার করেছে (link) (স্পেনীয়)
↑ As shown on the coat of arms.
↑ । ২০০৬-১০-০৫ তারিখে  থেকে আর্কাইভ করা। সংগ্রহের তারিখ ২০০৬-০৮-০২। উদ্ধৃতি টেমপ্লেট ইংরেজি প্যারামিটার ব্যবহার করেছে (link)
↑ 
↑ Section 40 of । ২০০৬-০৯-২৩ তারিখে  (DOC) থেকে আর্কাইভ করা। সংগ্রহের তারিখ ২০০৬-০৮-২৭। উদ্ধৃতি টেমপ্লেট ইংরেজি প্যারামিটার ব্যবহার করেছে (link)
↑ । সংগ্রহের তারিখ ২০০৬-০৮-০২। উদ্ধৃতি টেমপ্লেট ইংরেজি প্যারামিটার ব্যবহার করেছে (link)
↑ । সংগ্রহের তারিখ ২০০৬-০৮-০২। উদ্ধৃতি টেমপ্লেট ইংরেজি প্যারামিটার ব্যবহার করেছে (link)
↑ 
↑ । সংগ্রহের তারিখ ২০০৬-০৮-০২। উদ্ধৃতি টেমপ্লেট ইংরেজি প্যারামিটার ব্যবহার করেছে (link)
↑ । ২০০৬-১১-১৯ তারিখে  থেকে আর্কাইভ করা। সংগ্রহের তারিখ ২০০৬-০৮-০২। উদ্ধৃতি টেমপ্লেট ইংরেজি প্যারামিটার ব্যবহার করেছে (link)
↑ । সংগ্রহের তারিখ ২০১২-০১-০৭। উদ্ধৃতি টেমপ্লেট ইংরেজি প্যারামিটার ব্যবহার করেছে (link)
↑ As shown on the coins; see for example । ২০০৭-০৪-২৮ তারিখে  থেকে আর্কাইভ করা। সংগ্রহের তারিখ ২০০৬-০৮-০৪। উদ্ধৃতি টেমপ্লেট ইংরেজি প্যারামিটার ব্যবহার করেছে (link) (স্পেনীয়)
↑ As shown on the Coat of arms of Botswana.
↑ 
↑ । ২০০৬-০৮-০৪ তারিখে  থেকে আর্কাইভ করা। সংগ্রহের তারিখ ২০০৬-০৮-০৫। উদ্ধৃতি টেমপ্লেট ইংরেজি প্যারামিটার ব্যবহার করেছে (link)
↑ । সংগ্রহের তারিখ ২০০৬-০৮-০৫। উদ্ধৃতি টেমপ্লেট ইংরেজি প্যারামিটার ব্যবহার করেছে (link)
↑ । সংগ্রহের তারিখ ২০০৬-০৮-০৫। উদ্ধৃতি টেমপ্লেট ইংরেজি প্যারামিটার ব্যবহার করেছে (link) (ফরাসি)
↑ Article 7 of  (PDF)। ২০০৬-০৮-২৪ তারিখে  (PDF) থেকে আর্কাইভ করা। সংগ্রহের তারিখ ২০০৬-০৮-০৫। উদ্ধৃতি টেমপ্লেট ইংরেজি প্যারামিটার ব্যবহার করেছে (link) (ফরাসি)
↑ । সংগ্রহের তারিখ ২০০৬-০৮-২২। উদ্ধৃতি টেমপ্লেট ইংরেজি প্যারামিটার ব্যবহার করেছে (link)
↑ । সংগ্রহের তারিখ ২০০৬-০৮-২৭। উদ্ধৃতি টেমপ্লেট ইংরেজি প্যারামিটার ব্যবহার করেছে (link)
↑ Article 4 of । ২০০৬-০৭-১৬ তারিখে  থেকে আর্কাইভ করা। সংগ্রহের তারিখ ২০০৬-০৮-২২। উদ্ধৃতি টেমপ্লেট ইংরেজি প্যারামিটার ব্যবহার করেছে (link) (ফরাসি)
↑ । ২০০৮-০৪-১১ তারিখে  থেকে আর্কাইভ করা। সংগ্রহের তারিখ ২০০৬-০৮-২৩। উদ্ধৃতি টেমপ্লেট ইংরেজি প্যারামিটার ব্যবহার করেছে (link)
↑ Article 25 of  (PDF)। ২০০৬-০৯-২৩ তারিখে  (PDF) থেকে আর্কাইভ করা। সংগ্রহের তারিখ ২০০৬-০৮-২৬। উদ্ধৃতি টেমপ্লেট ইংরেজি প্যারামিটার ব্যবহার করেছে (link) (ফরাসি)
↑ Article 9 of  (PDF)। সংগ্রহের তারিখ ২০০৬-০৮-২৭। উদ্ধৃতি টেমপ্লেট ইংরেজি প্যারামিটার ব্যবহার করেছে (link) (ফরাসি)
↑ । সংগ্রহের তারিখ ২০০৬-০৮-২৭। উদ্ধৃতি টেমপ্লেট ইংরেজি প্যারামিটার ব্যবহার করেছে (link)
↑  (PDF)। সংগ্রহের তারিখ ২০১৩-০৮-২১। উদ্ধৃতি টেমপ্লেট ইংরেজি প্যারামিটার ব্যবহার করেছে (link)
↑ । সংগ্রহের তারিখ ২০০৬-০৮-০৩। উদ্ধৃতি টেমপ্লেট ইংরেজি প্যারামিটার ব্যবহার করেছে (link) (ফরাসি)
↑ 
↑  (PDF)। ২০০৬-০৮-২৪ তারিখে  (PDF) থেকে আর্কাইভ করা। সংগ্রহের তারিখ ২০০৬-০৮-০৮। উদ্ধৃতি টেমপ্লেট ইংরেজি প্যারামিটার ব্যবহার করেছে (link) (ফরাসি)
↑ Article 6 of  (PDF)। সংগ্রহের তারিখ ২০০৬-০৮-২৭। উদ্ধৃতি টেমপ্লেট ইংরেজি প্যারামিটার ব্যবহার করেছে (link) (ফরাসি)
↑ । সংগ্রহের তারিখ ২০০৬-০৮-২২। উদ্ধৃতি টেমপ্লেট ইংরেজি প্যারামিটার ব্যবহার করেছে (link)
↑ । ২০০৬-০৯-০৫ তারিখে  থেকে আর্কাইভ করা। সংগ্রহের তারিখ ২০০৬-০৮-২২। উদ্ধৃতি টেমপ্লেট ইংরেজি প্যারামিটার ব্যবহার করেছে (link)
↑ । ২০০৬-০৮-২৪ তারিখে  থেকে আর্কাইভ করা। সংগ্রহের তারিখ ২০০৬-০৮-২২। উদ্ধৃতি টেমপ্লেট ইংরেজি প্যারামিটার ব্যবহার করেছে (link)
↑ । সংগ্রহের তারিখ ২০০৬-০৮-২২। উদ্ধৃতি টেমপ্লেট ইংরেজি প্যারামিটার ব্যবহার করেছে (link)
↑ । সংগ্রহের তারিখ ২০০৬-০৮-০২। উদ্ধৃতি টেমপ্লেট ইংরেজি প্যারামিটার ব্যবহার করেছে (link)
↑ । সংগ্রহের তারিখ ২০০৬-০৮-০২। উদ্ধৃতি টেমপ্লেট ইংরেজি প্যারামিটার ব্যবহার করেছে (link)
↑ । সংগ্রহের তারিখ ২০০৬-০৮-০২। উদ্ধৃতি টেমপ্লেট ইংরেজি প্যারামিটার ব্যবহার করেছে (link)
↑ । ২০০৭-০৯-২৮ তারিখে  থেকে আর্কাইভ করা। সংগ্রহের তারিখ ২০০৬-০৮-২৭। উদ্ধৃতি টেমপ্লেট ইংরেজি প্যারামিটার ব্যবহার করেছে (link)
↑ As shown on the flag of Saudi Arabia.
↑ । ২০০৬-০৭-২৫ তারিখে  থেকে আর্কাইভ করা। সংগ্রহের তারিখ ২০০৬-০৮-২৭। উদ্ধৃতি টেমপ্লেট ইংরেজি প্যারামিটার ব্যবহার করেছে (link)
↑ । সংগ্রহের তারিখ ২০০৬-০৮-০২। উদ্ধৃতি টেমপ্লেট ইংরেজি প্যারামিটার ব্যবহার করেছে (link)
↑ Ministry of Information and National Guidance of Somalia (১৯৭৩)। । Ministry of Information and National Guidance of Somalia। উদ্ধৃতি টেমপ্লেট ইংরেজি প্যারামিটার ব্যবহার করেছে (link)
↑ । সংগ্রহের তারিখ ২০০৬-০৮-২৭। উদ্ধৃতি টেমপ্লেট ইংরেজি প্যারামিটার ব্যবহার করেছে (link)
↑ Paul Preston (১৯৯৮)। । Plaza & Janés। পৃষ্ঠা 81–83। আইএসবিএন 8401530261। উদ্ধৃতি টেমপ্লেট ইংরেজি প্যারামিটার ব্যবহার করেছে (link)
↑ As shown on the Coat of arms of Sudan
↑ । সংগ্রহের তারিখ ২০০৬-০৮-০২। উদ্ধৃতি টেমপ্লেট ইংরেজি প্যারামিটার ব্যবহার করেছে (link)
↑ । সংগ্রহের তারিখ ২০০৬-০৮-২৭। উদ্ধৃতি টেমপ্লেট ইংরেজি প্যারামিটার ব্যবহার করেছে (link)
↑ । সংগ্রহের তারিখ ২০০৬-০৮-০২। উদ্ধৃতি টেমপ্লেট ইংরেজি প্যারামিটার ব্যবহার করেছে (link)
↑ । সংগ্রহের তারিখ ২০০৬-০৮-২২। উদ্ধৃতি টেমপ্লেট ইংরেজি প্যারামিটার ব্যবহার করেছে (link) (স্পেনীয়)









দে



জাতীয় প্রতীক



প্রবন্ধ



রং
খাবার
প্রতীক
মহাকাব্য
ফুল
মিথ
ব্যক্তিরূপ
নদী
ক্রীড়া





তালিকা



প্রাণী
সঙ্গীত
পাখি
ফল
প্রতিষ্ঠাতা
বাদ্যযন্ত্র
নীতিবাক্য
কবি
গাছ











